1. Пистолеты (Меню B -> 1)
Всего 6 единиц оружия. У каждой команды есть стартовый пистолет, остальные можно докупить. 
Название 	Команда	Пункт меню	Примечание
Glock 18	Террористы (T)	1	Стартовое оружие
USP Tactical	Спецназ (CT)	2	Стартовое оружие (с глушителем)
P228	Обе команды	3	
Desert Eagle	Обе команды	4	
Dual Berettas	T (Dual Elites)	5	
Five-SeveN	CT (ES Five-seven)	5	
2. Дробовики (Меню B -> 2)
Всего 2 единицы оружия, доступны обеим командам. 
Название	Команда	Пункт меню
M3 Super 90	Обе команды	1
XM1014	Обе команды	2
3. Пистолеты-пулеметы (ПП/SMG) (Меню B -> 3)
Всего 5 единиц оружия. 
Название	Команда	Пункт меню
MAC-10	T (Ingram Mac-10)	1
TMP	CT (Schmidt Machine Pistol)	1
MP5-Navy	Обе команды	2
UMP-45	Обе команды	3
P90	Обе команды	4
4. Винтовки (Меню B -> 4)
Всего 10 единиц оружия (6 штурмовых и 4 снайперских). 
Название 	Команда	Пункт меню	Примечание
Galil AR	T (IDF Defender)	1	Штурмовая винтовка
FAMAS	CT (Clarion 5.56)	1	Штурмовая винтовка
AK-47	T (CV-47)	2	Штурмовая винтовка
M4A1 Carbine	CT (Maverick Colt M4A1)	2	Штурмовая винтовка (с глушителем)
Scout	Обе команды	3	Снайперская винтовка (Schmidt Scout)
SG 552 Commando	T (Krieg 552)	4	Штурмовая винтовка
AUG	CT (Bullpup)	4	Штурмовая винтовка
AWP	Обе команды	5	Снайперская винтовка (Magnum Sniper Rifle)
G3SG1	T (D3/AU-1)	6	Автоматическая снайперская винтовка
SG 550 Commando	CT (Krieg 550 Commando)	6	Автоматическая снайперская винтовка
5. Пулеметы (Меню B -> 5)
Единственный пулемет, доступный обеим командам. 
Название	Команда	Пункт меню
M249	Обе команды	1
6. Снаряжение (Меню B -> 8)
Меню снаряжения содержит предметы поддержки и бронежилеты. 
Название 	Пункт меню	Примечание
Бронежилет (Vest)	1	
Бронежилет и шлем (VestHelm)	2	
Светошумовая граната (Flashbang)	3	
Осколочная граната (HE Grenade)	4	
Дымовая граната (Smoke Grenade)	5	
Набор сапера (Defuse Kit)	6	Доступен только CT
Прибор ночного видения (NVGs)	7	
Тактический щит (Tactical Shield)	8	Доступен только CT в режиме "Casual"
Прочее
Нож (Knife): Не покупается и не выбрасывается, всегда доступен в слоте ближнего боя.
C4: Устройство для закладки бомбы, автоматически выдается одному из террористов в начале раунда на картах типа "de_". 